%%%%%%%%%%%%%%%%%%%%%%
%o.........G .......o%
%..%%..%%%..%%...%%..%
%..%.....%...%...%...%
%..%..%%.%..%%%..%%..%
%..%..%%.%..G .....%.%
%..%%....%%..%%.%%..%%
%......%%..%%..%%....%
%..%%%%.%%..%%...%%..%
%..%.....%%.%%%..%%..%
%..%....%%%...%......%
%..%...%.....%..%..%.%
%..%%.%%%..%%%%%%.%%.%
%o....G G .......P...%
%%%%%%%%%%%%%%%%%%%%%%
